#.1.######################
#.S.######################
#...######################
#...######################
#........................#
#......................CC#
#......................###
#..................CC....#
#......CCCCCCCCCC..##....#
#......CCCCCCCCCC........#
#......##########........#
#......CCCCCCCCCC....22..#
#......CCCCCCCCCC....00..#
##########################
##########################